Niveau 2
EEEEEEEEEEEEEEEEEEEEEEE
EEEEEEEEEEEEEEEEEEEEEEE
EEEEEEEEEEEEEEEEEEEEEEE
EEIIIEEEEIIIIIEEEEIIIEE
EEIIIEEEEIIIIIEEEEIIIEE
EEIIIIEEIIIIIIIEEIIIIEE
EEIIIIEEIIIIIIIEEIIIIEE
EEEEEEEEEEEEEEEEEEEEEEE
EEEEEEEEEEEEEEEEEEEEEEE
EEEEEEEEEEEEEEEEEEEEEEE
EEEEEEEEEEEEEEEEEEEEEEE
EEEEEEEEEEEEEEEEEEEEEEE
EEEEEEEEEEEEEEEEEEEEEEE
EEEEEEEEEEEEEEEEEEEEEEE
EEEEEEEEEEEEEEEEEEEEEEE
EEEEEEEEEEEEEEEEEEEEEEE
EEEEEEEEEEEEEEEEEEEEEEE
XEEEEEEXXEEEEEXXEEEEEEX
XEEEEEEXXEEEEEXXEEEEEEX
EEEEEEEEEEEEEEEEEEEEEEE
EEEEEEEEEEESEEEEEEEEEEE
EEEEEEEEEEEEEEEEEEEEEEE