Niveau 9
EEEEEEEEEEEEEEEEEEEEEEE
EEEEEEEEEEEEEEEEEEEEEEE
EEEEEEEEEEEEEEEEEEEEEEE
EEEEEEEEEEEEEEEEEEEEEEE
EEIIIIEEIIIIIIIEEIIIIEE
EEEEEIEEEEIIIEEEEIEEEEE
EEEEEEEIIIIIIIIIEEEEEEE
EEEEEEIIIIIIIIIIIEEEEEE
EEEEEEEEEEIIIEEEEEEEEEE
EEEEEEIIIIIIIIIIIEEEEEE
EEEEEEEEEEEEEEEEEEEEEEE
EEEEEEIIIIIIIIIIIEEEEEE
EEEEEEEEEEIIIEEEEEEEEEE
EEEEEEEEIIIIIIIEEEEEEEE
EEEEEEEEEEIIIEEEEEEEEEE
EEEEEEEEEEEEEEEEEEEEEEE
EEEEEEEEEEEEEEEEEEEEEEE
XEEEEEEEEEEXEEEEEEEEEEX
XEEEEEEEEEEXEEEEEEEEEEX
EEEEEEEEEEEEEEEEEEEEEEE
EEEEEEEEEEESEEEEEEEEEEE
EEEEEEEEEEEEEEEEEEEEEEE