Niveau 8
EEEEEEEEEEEEEEEEEEEEEEE
EEEEEEEEEEEEEEEEEEEEEEE
EEEEEEEEEEEEEEEEEEEEEEE
EEEEEEEEEEEEEEEEEEEEEEE
EEIIIIEEIIIIIIIEEIIIIEE
EIIIIIEEEEIIIEEEEIEIIIE
EEEEEEEIIIIIIIIIEEEEEEE
EEEEEEIIIIIIIIIIIEEEEEE
EEEEEEEEEEIIIEEEEEEEEEE
EEEEEEIIIIIIIIIIIEEEEEE
EEEEEEEEEEEEEEEEEEEEEEE
EEEEEEIIIIIIIIIIIEEEEEE
EEEEEEEEEEEEEEEEEEEEEEE
EEEEEEEEEIIIIIEEEEEEEEE
EEEEEEEEEEEEEEEEEEEEEEE
EEEEEEEEEEEEEEEEEEEEEEE
EEEEEEEEEEEEEEEEEEEEEEE
XEEEEEEEEEEXEEEEEEEEEEX
XEEEEEEEEEEXEEEEEEEEEEX
EEEEEEEEEEEEEEEEEEEEEEE
EEEEEEEEEEESEEEEEEEEEEE
EEEEEEEEEEEEEEEEEEEEEEE